5 8
1s111000
10000010
10111110
10000000
1111111e